atlas（十二titan的名字）	地图册

hemi- / demi-	/ semi-/
hemisphere	半球
demigod 半人半神
semiconductor	半导体 ------conductor	导体

meridian	经线；子午线		longitude	经度
parallel	纬线		latitude	纬度

altitude	高度--------->联想词 elevation	海拔	-------------->联想词	elevator	电梯
aptitude	天资	-------------->apt 合适的；聪明的
attitide	态度

-tude	程度；性质
solitude	孤独
fortitude	坚强


contour	等高线；轮廓  （在美容领域，表示人的脸的轮廓）
horizon	地平线；视野
horizontal	水平线；水平的
vertical	垂直的


equator	赤道			equinox	分 			vernal equinox 春分 	 vernal 春天的；和煦的；青春的
autumnal equinox 秋分	
frigid	adj. 寒冷的，严寒的；冷淡的  frigid zone 寒带
tropical	热带的；热情的
temperate	温带的--->	联想词	temperature    温度   ||tempt	vt. 诱惑；引起；冒…的风险；使感兴趣	||tempter		n. 诱惑者；魔鬼；撒旦   --devil


the Arctic	北极
the	Antarctic	南极	----> anarchic  adj. 无政府的；无政府主义的；无法无天的
pole	极点；杆子（电线杆）
polar	极地的

topography	地形学；拓扑学
merase	酶  ——> enzyme	
topoisomerase	拓扑异构酶

plateau 高地；平顶女帽	黄土高原loess plateau     青藏高原tibetan plateau  
 loess	黄土	Tibet  西藏

------------>highland	高地
	plateau  也可以暗指达到饱,处于比较稳定的状态
	fluctuate	起伏动荡  Fruit prices fluctuate with the seasons.
lowland		低地
basin	盆地；脸盆
	the athletic footwear market has not yet plateaued.	运动员的球鞋市场还没达到饱和。


avalanche		雪崩

cavern	 洞穴	cavernous	空旷的；如洞穴般的
cave    洞
grotto	洞（可以是天然，也可以是人工）—————————————>联想到溶洞
burrow	地下洞穴-------------->兔子洞、土拨鼠洞

cleft	裂隙	（cleave	------>劈开）----->cleft lip	兔唇  （想想家里的小兔子）
breach	关系的裂隙（抽象意义上的）
gap		空缺；大的差别————————————>代沟 generation gap 
chasm	巨大的分歧（政治观点不同；意见上的不同）；裂缝；鸿沟；峡谷

terrain	地形
terra-	 地
terrestrial	地球的；陆地的
subterranean	地下的
extraterrestrial	ET 外星人
terrace 梯田
territory	领地
	a territorial dispute	领土争端

the Mediterranean	 地中海

sporadic	零星的  scattered	-------------->散点图
oasis	绿洲（沙漠的绿洲）----------->haven  联想词--->heaven	 天堂	
an oasis of serenity  宜人的地方

range 山脉;范围
edge	边缘；边际----->pledge
ledge 岩脊；壁架(凸出来的地方)----------->联想家里面的书架、想想罗汉岩
niche	壁龛	；生态位------------->想想老家家里面供奉神像的地方  凹进去的部分就是壁龛
ledger	分类账

ridge	山脊
canyon	峡谷	 ----------------> 东非大裂谷
valley	峡谷--------------比较文艺；童话里面的
gorge  峡谷-------------->山峡
strait  海峡------------->白令海峡

ebb 退潮
serene	平静的
serenity	== tranquility

creek	小溪
brook	 小溪(常用于文学)
	He would brook no criticism.  他无法忍受批评

canal	 运河  ----->加拿大运河

trickle	滴滴地流	------->想想打点滴的场景
trickle-down effect 	渗透效应
tickle 	挠痒；逗乐
tinkle	发出叮当声
tingle	感到刺痛	(pang)
	she tingle with excitement. 她非常兴奋。

twinkle	闪烁


cascade	倾泻；小瀑布	------------->想想老家里面的那条小河
	this information will be cascaded down to the employees through their line managers.	信息向下流通
cataract	大瀑布；（医学上）白内障----->向白色的瀑布遮主眼睛上

converge	汇合
verg- 转;倾斜
diverge	分歧（两个人背对背转身）------------>想想X教授和万磁王----->divergent 有分歧的
verge	边缘
on the verge of extinction	濒临灭绝

limpid	清澈的；流畅的

puddle	 小水坑；小水洼
	peddle	兜售；叫卖
	paddle 	船桨
	pedal	可表示自行车的脚踏板--------(ped- 脚）
	pebble 卵石
	pit  坑

lagoon  泻湖	  （珊瑚礁海域，由珊瑚虫堆出来的礁围起来的海域）

cruise	巡航  （娱乐、浏览性质，不用于保安巡逻）
	cruise	the River Seine 沿着塞纳河游玩

delta	三角洲  	------------>长江三角洲
islet	小岛

uncharted		未被标注的
chart 航海图；排行榜

peninsula	半岛（三面环海）
insular	与世隔绝的（provincial 狭隘的）
insularity	岛国特质（井底之蛙，没见过世面之意）

insulation	绝缘；隔离；隔热------------->insulate	
desolate	荒凉的
insolate	暴晒
isolate 孤立
insulin  胰岛素 

hazy	摸棱两可的
interred	埋葬

	terracotta	warriors	兵马俑

geology		地质学
geo-	地(来自于第一代天神的母亲 ---->盖亚	大地之母)
geography	地理
geometry	几何(测量大地几何学的发展)
geopolitics		地缘政治
geothermal	地热的
geotropism	向地性


stratum	地层---->复数形式 strata
	hierarchy	社会阶层；地层------------>hierarchical	adj.社会阶层的
crust	地壳
mantle	地幔
core    地心

plate  板块；车牌（美国人）
	a gold-plated watch	镀金的表

fault 	断层；责任；故障
glitch	（机器）小故障
flaw	缺陷；毛病
defect	（先天性的）疾病

rift	断裂
fracture	断裂；骨折
crack		非法侵入；
rupture	肠子（内脏）的断裂

grain 纹理；谷物
	a grain of sand	 一粒沙子
grainy black and white photos	像素低的
granary	粮仓

texture	纹理

intergration	融合
disintergration	分解
decomposition	分解

decomposer	分解者---------->细菌；真菌等
compose	组装;写作；作曲
comoser	作曲家


erosion	腐蚀	；损耗（风和水对物质等的破坏，风化等）-----------> erode	vt 腐蚀

corrode		削弱
wear away	磨损

quartz	石英	------------->联想词quart	容积单位,约为1L
sediment	沉淀物
sed-	sed-	坐
sedentary	久坐的
sedate	安静的
sedan  轿车
reside	居住
preside  主持

limestone	石灰岩
limelight	可以大致理解为聚光灯

-ive 在作名词后缀时，通常表示药剂，药品等

marble	大理石
	marbled	meat 大理石肉

granite	花岗岩

magma	岩浆
lava  （喷出的）熔岩

mineral	矿物
ruby	红宝石
emerald	绿宝石
diamond	钻石
sapphire 蓝宝石
jade 玉；翡翠
crystal  水晶
turquoise  绿松石
opal  蛋白石;猫眼石


deposit  矿床
ore	矿石
gem 宝石

amber  琥珀

opal  蛋白石；猫眼石
opaque	不透明的
opalescent	乳白色

glacier	冰川
glacial	冰川的

peril 危险
perilous 危险的
hazard	（潜在的）危险的
risk  风险（投资风险等）

catastrophe 灾祸
apocalypse	大灾难;天启-------------->想想X战警：天启
cataclysm 大灾难
catastrophic=====apocalyptic	灾祸的；（划重点）

deleterious	有害的；联想词---------->detrimental  noxious   pernicious baleful 有害的
	He worked very long hours,to thr detriment of his marriage。
vehement 猛烈的-------->联想词  violent fierce

avalanche  雪崩
	an avalanche of application	------->一系列突然猛涨的

eruption 火三喷发
ash 灰烬
volcanic	 火山的
extinguish  熄灭；解渴
quench  解渴的
extinct  灭绝------------>extinction	 灭绝

fountain 喷泉
geyser	间歇泉

tremor 地震；震动
tremulous 害怕到发抖的
tremble 颤抖

seismology 地震学
epicentre 震中（）地震中心
epidermis  皮上组织

magn-	大
magnitude	重要性，震级
magnificent 辉煌的

evacuate 疏散
eradicate  根除






