chemical bond  化学键

chemical adj.化学的；n.化学物质
compound（com 共同） 化合物；复合物
compound eye  复眼 （比如:蜻蜓的眼睛）
compound a problem 使问题更加严重

composite (合成的)图片，比如PS

bond  纽带;债券

bind 捆绑
bound 必然的，密切的	前往的
	the ship was bound for Italy.  这个船是驶向意大利的。

pond 池塘
pound 英镑；重击:也可以指"#"键

derive	起源于
derivative	衍生物



spontaneous   自发的	---aneous  形容词，词缀
	entropy	熵(混乱程度);	
	combustion	燃烧

instantaneous 	即兴的
simultaneous	同时的
improvise		即兴演出
impromptu	即兴的
simultaneity	同时

periodic	周期
periodical   期刊

hydro-	水
hydrogen	氢
Hydra	（神话中的）九头蛇；水栖

hydroelectric 水力发电
hydrophobia	恐水症；---->狂犬病

inflamable	易燃的
flame	火焰
inflame 加剧
inflammation	炎症

oxygen 氧
oxide	氧化物	---ide  化物 	--ate盐
nitrogen 氮



ammonia		氨	
amino acid	氨基酸
helium	氦	He
inert	 惰性的
inertia	惯性；惰性

carboon	碳	C
calcium	钙	Ca
silicon	硅	Si  ------------>silicon valley	硅谷

ammonium bicarbonate	碳酸氢铵
calcium	carbonate	 碳酸钙
nitric oxide	一氧化氮（空气污染物）
sulphur 	硫 	S
iodine	碘	I
platinum	白金；铂金
silver	银


silver chloride	氯化银 Agcl
potassium iodide	碘化钾
 

copper	铜
bronze	青铜（铜锡合金）
brass	黄铜（铜锌合金）

	brassy music   刺耳的音乐
	brussy wife	唠叨吵闹的妻子

aluminium	铝 	Al
tin	锡
lead 	铅

tenuous	细的
tenuous career	不稳定的职业
tenure	任期（重要职务的任期）；终身教职

compact	压缩的；小巧精美的

supple	形容身体非常柔软的		flexible	制度安排比较灵活，身体柔韧性好
stift	形容身体非常僵硬的		rigid	制度僵硬、物体不易弯曲
flimsy	脆弱的；（经不起推敲，打击的）


fragile	脆的
crisp	脆的；薯条
fragmented	碎片化的
fragment	碎片
fragmentation	碎片化
fragmentary	碎片的

nickel	镍；（在小说中，加拿大的五分钱）
alloy	合金
ally	同盟	alliance	团体	
allay	减轻
allery	小巷；胡同

malleable	有延展性的

dent-	牙
dentist	牙医
dented	凹陷的；（被牙咬过的）
indent	锯齿状的；缩进

sodium	钠
den	动物的巢穴；（一般住着可怕的怪兽）


sodium	chloride	氯化钠


ac-	尖
acid	酸

acidulous	尖酸的
acrimonious	尖酸的、

alkali	碱

acrid	辛辣的（食物、气味）

acute	尖锐的；聪明伶俐的；	acute angle--->锐角
acumen	聪明；敏锐

caustic	腐蚀性的
vitriolic	言语辛辣的

volatile	挥发性的（化学性质）；易怒，易激动（情绪不稳定的）；政权更迭的无常（政权的不稳定）

spout	喷射
spray	喷雾；喷雾器	
flare	突然燃烧的
glare	怒目而视，闪耀

singe	烧焦
ignite	（学术上的）点燃			――――>burn
trigger	触发器
scorch	灼烧	==	sear 	烧焦的
spark	激发；引起；求婚	n.火花；闪烁

alchemy	炼金术

prtrify	石化
petrol	石油	=====gasoline	美式英语
petroleum		石油
crude	oil	原油
refine	精炼
refinery	精油厂

barrel	桶；	v.飞奔
extract	提取；提炼

tar	焦油；尖刻的	（蛋挞）
tart	馅饼

gaseous	气态的


neutral	中性的	酸碱中性；电中性；生物的中性
neutralize		阉割（想想太监）；中和；（在政治方面，使无效；中立）

solution	溶液
dissolve	溶解
saturate	使饱和



solvent	溶剂
insoluble	不能解决的，不容的	
insolvent	破产的 （流动性资产，不能流动）

sediment	沉淀物
deposit	沉淀物


particle	粒子
atom	原子
atomic	原子的
molecule		分子
molecular		分子的
nucleus	原子核
electron	电子
ion	离子
neutron	中子
proton	质子
	-on		子

photon	光子
fuse	保险丝；聚合；雷管
defuse	缓和
fusion	核聚变
	

	-lysis	分解

	
analysis	分析
catalysis	催化作用
catalyst	催化剂
catalyze	催化

apparatus		器械（一般用于实验室）
flask	烧瓶、
beaker	烧杯
mortar	研钵
tongs	坩埚钳


artifical	人造的；虚伪的	----->genuine	真诚的
synthetic	合成的 		 synthesize	合成  	synthesis	合成物	

polymer	聚合物-------->nylon	 尼龙
polyester	聚酯纤维；涤纶


cosmetics	化妆品
dye	染料
affinity	亲和
plastic	塑料

mechanism	机制
mechanics	力学
merchant	商人
merchanic		技工


optics	光学
optical	光学的
magnet	磁铁
magnetic	磁性的（也可以形容声音的磁性）
electromagnetism	电磁学

Nuclear fusion  核聚变
Nuclear fission  核裂变


mortar  n. 迫击炮；臼，研钵；灰浆	
test tube 试管

	











