dynamics 动力学

dynam-力

dynamic 有活力的
dynamo  发电机；精力充沛的人-------generator
dynamite	炸药；（具有轰动效应的人或者具有破坏性的人）
hydrodynamics	流体力学


cohere	聚合
cohesion	凝聚力
cohesive	有凝聚力的
coherent	连贯的；（形容文字）


her-附着 坚持
inherent	固有的
heredity	遗传性   genetics------>遗传学


adhere	黏着
adherent 追随者；跟屁虫
cling 黏附

friction	摩擦
resistance 阻力；电阻；免疫力；抵抗

velocity	速度
celerity	迅速 	-------cele	 速度
acceleration	加速度
excel	胜过
equilibrium 	平衡	balance	
equivalent		等价物

motion	运动；vt  示意  ========gesture 手势

motive	动机

speedy=swift=rapid  迅速的
prompt  迅速的

duration	 持续时间
dur-		坚硬
durable	持久的
endure	忍受

a spasm of  一阵
eg：I felt a spasm of fear.

synchronize	同步
	Cronus  希腊神话里面的
chron	-时间

chronic	慢性的  ---------------> acute	急性的
chronological	时间顺序的  
chronicle	编年史 vt 记载
syn-同步

synthesis	合成;化学合成
deviate	偏离====>   deviation

mass  	质量
mess	脏乱
density	密度  ------->（dense）
momentum	动量
volume	体积;音量
inertia	惯性

relativity	相对 
relative	相对的；亲戚
gravity	重力;严重性

grav-	重
grave	重大的；坟墓
gravitate	偏向

aggravate	加重，恶化 ========escalate
escalator	自动扶梯
grievous	严重的
grief	悲痛

vibration 震动   =======  vibrate
reverberate	回响；震荡

medium	媒介 ------>复数  media         
plural  复数	  
singular	单数

frequency	频率
pitch	音调；vi. 倾斜；投掷；搭帐篷；坠落；n. 沥青；音高；程度；树脂；倾斜；投掷；球场
high-profile 做事高调的

intensity	 强度   intensify  加强
intensive		密集的


decibel	分贝
echo 回声	--------------->来自于一个女神的名字
resonance		回声；洪亮；共鸣


son-声音
sonorous	洪亮的
sonar	声纳
supersonic	超音速的
	

unison	一致
dissonance	不一致
consonant	辅音



magnetic field 磁场

static 静电
induction	电磁感应；入门，就职  ==inauguration	
induce 引起

alternating current 	(AC) 交流电
alternate 	v.交替 adj 间隔的

alternative	选项	
alter 改变
electric charge  电荷
	charge  收费；充电；冲锋

voltage	电压
volt 伏特
amphere 安培

HI-FI  高保真

fid- 相信
infidel	异教徒
confidence	自信
confide	吐露
confidante	闺蜜
perfidy	不忠

resolution 解析度；决定；解决---------->分辨率
resolute 果断的
configuration 配置


electric appliance	电器
apparatus 科学设备;组织机构
equipment  工作娱乐用的设备，器材
stuff	东西；填满；塞满	

insulator	 绝缘体
semiconductor  半导体
conduct	 指挥；传导；实施 
conducive		有帮助的

batter 重击  
battery ==cell（口语）	电池
integrated circuit 集成电路
integrated schools 综合性大学
integral	积分的
integrity	 正直

chip （英式）薯条；芯片;缺口
cable	缆绳
wire  金属丝；电线
cord  缆绳
grid  电网

fibre 	纤维  -------------->聚酯纤维  polyester	
lens	透镜；镜片
zoom(in/out)	变焦
contace	lens 隐形眼镜
prism 	棱镜
telescope 望远镜
microscope	显微镜
magnifier	放大镜

magnitude	放大镜
magnificent 	辉煌的


diffusion	漫反射；扩散
diffuse	散布

disperison	色散
disperse	驱散
dispel  scatter	 驱散
disperse the crowd 驱散人群

spectrum	光谱
spec--看
spectator 观众
apectacle	奇观；
spectacle 壮观的
prospect	前景
aspect	方面
suspect  怀疑；嫌疑人
inspect 仔细检查
retrospect		回顾
perspective 	观点；透视
prospective 潜在的

transparent	透明的		
opacity 	不透明
translucent	半透明的




luc-  lus- 光
elucidate	==illuminate==illustrate	阐明
pellucid	清澈透明的 ；（常用来形容抽象事物）

lucid 	清晰透明的；糊涂的人变明白
luminous 发光的
luminary	 发光体;名人--------------> celebrity  名人


dim  暗的； n.笨蛋，傻子
murky  黑暗的，朦胧的
gloomy  悲观的；黑暗的；忧郁的


gleam	微光
glitter ===glimmer== glient=== sparkle  散散发光的
glisten	油光

dazzling	耀眼的  （褒义词）
glaring   显眼的 （贬义词）

therm -热
thermometer	温度计
thermal	热的
geothermic	地热的	

Celsius 摄氏度
centigrade 摄氏度
Fahrenheit	华氏度
Kelvin		开尔文
、

distil	蒸馏
instil	灌输；（抽象意义上的）
thaw	(冰雪)融化;  	freeze	冻上
melt	（金属、巧克力、抽象意义上的）融化



stretch	伸展，伸张  	extend	--------->线性延伸
enlarge  扩大 	expand------->径向延伸
enhance	 增加 （提高效率）――――>increase  rise  augment grow swell add ramp up
aggrandize	夸大的  grand  辉煌的 
grandiose  华而不实
hump	隆起，驼峰  
bump ------> bumpy 坑洼不平的
swell----->医学上的隆起

contract	收缩；  合同---------->shrink
abate 减少   decrease lessen diminish reduce cut dro[ descend
descent	下降 


concave	凹的
convex	凸的
project	凸出  ――>projector  投影仪
protrude	突出  ---->stick out
transform	变形
transfigure	美化(好的感情色彩)
deform  使变形（丑化）
draw  吸引；拉（attract,appeal to）
proximity	临近  propinquity vicinity
approximate	大概的
adjoin	贴近
adjacent	邻近的；be adjacent to ==be close to 


tilted	倾斜的； inclined	
slant  斜面 倾向性  ramp(可用来指为残疾人用的斜坡通道) slope	
coil  盘绕  
twist 	纽
tangle entangle wind entwine	 纠结


dangle	悬摆
suspend	暂停 
encompass	包围  envelop
compass	罗盘；圆规











