dimension	维度；尺寸
facet	面
measurement		测量维度（比如长宽高）

perpendicular	(科学用于)垂直的---->vertical
quadrilateral	四边形
erect	竖直
correct	 纠正

	quick response code---->QR code 二维码

gon-	角
diagonal	对角线的
polygon		多边形
Pentagon	五角大楼
facade		建筑物正面，表象
volume		体积

cylinder	气缸；圆柱
cone		圆锥；松塔
oval	椭圆
eliipse		椭圆形（比较专业）
ellipis		省略
elliptical		椭圆的；省略的


dia-	横跨

circum-	周，环绕 （来源于circle）
cirrcumference		圆周
circumtance		文化
circumscribe		限制，约束，控制
circumvent		（贬义）绕道；用小聪明回避一些问题
circumspect			小心谨慎的；周到的
calibre			口径；能力
diameter	直径
radius		半径


parabola		抛物线	(bola-	拉丁词根  抛)
hyperbola	双曲线

ballistics		弹道学


linear thinking		正常推理		a-->b b-->c
lateral	thinking	侧面推导

unilateral
bilateral

tang-	接触
tangent		切线
tangential		相切的；擦边的
tangibble	清晰明确的
intangible		无形的

trigonometry	三角学
sine	正弦
sinuous		柔软的；弯曲的；
grace	优雅；恩惠；使优美

insinuate	暗示

tenuous		纤细的	（ten--拉，拽）
hypotenuse	斜边（hypo--在..之下）

calculus	微积分
calculate	计算
calcium		钙
chalk	粉笔；白垩

caulk	补漏；缝隙不渗水

integral		构成整体所必须的，积分的
integer		
differential	微分
successive		连续
	consecutive,incessant,constant,lasting
succession		继承，连续
perpetual	也指烦人的，不停的（continuous,continual）






